mmmmmmmmm
m...t...m
m.s...s.m
m.......m
ms......m
m....s..m
m.......m
m.s.....m
m.......m
m.......m
mp......m
mmmmmmmmm