d;d;d;t;d;d;d
d;s;d;d;d;s;d
d;d;d;d;d;d;d
s;d;d;d;d;d;d
d;d;d;d;s;d;d
d;d;d;d;d;d;d
d;s;d;d;d;d;d
d;d;d;d;d;d;d
d;d;d;d;d;d;d
k;d;d;d;d;d;d
